{
    "rows": 5,
    "columns": 8,
    "brickSpacing": {
        "x": 1.2,
        "y": 0.6
    },
    "brickLayout": [
        [ 1, 1, 1, 1, 1, 1, 1, 1 ],
        [ 1, 0, 0, 0, 0, 0, 0, 1 ],
        [ 1, 0, 1, 1, 1, 1, 0, 1 ],
        [ 1, 0, 0, 0, 0, 0, 0, 1 ],
        [ 1, 1, 1, 1, 1, 1, 1, 1 ]
    ]
}